[
  {
    "maze": [
      "#########",
      "#P  C  E#",
      "# ### ##",
      "#      #",
      "#########"
    ],
    "coins": 3
  }
]